#############
#          O#
#   P   #####
#           #
#######     #
#  O ##     #
#    ##     #
#O          #
#  X     XX #
#        #  #
#############