######
#    #
# XXX##
#  #OO###
##  OOX #
 # P    #
 ########